11111111111111111111111
10000000000000000000001
10000011111111111110001
10000C0000000000000C001
10000111111111111111101
1P0000000000E0000000001
10000111111111111111101
10000C0000000000000C001
10000011111111111110001
10000000000000000000001
11111111111111111111111